WWWWWWWWWW
W    C    
W T  W   W
WWX XXT  W
W  R WW CW
W  XXX  CW
W R  W   W
W W  W   W
W W BW FSW
WWWWWWWWWW