WWWWWWWWWW
W T     bW
WA       W
WBW      W
W A      W
WY    C XW
W    WWW W
W    F   W
W      RSW
WWWWWWWXWW