WWWWWW WWW
W  A     W
W  WT    W
WWYWWW   W
W  S W   W
WWYWWW   W
W    B   W
W  WWW   W
W     FFFW
WWWWWWWWWW