WWWWWWWWWW
W  B   C W
W  HHHH  W
W V      W
W V  WWXXW
W    W
W  S W   W
W    W   W
W  R     W
WWWWWWWWWW