WWWWWWWWWW
WA B W S W
W    W   W
W    WXXXW
W   bW   W
W    WXWXW
W    W   W
W    WWWXW
W T  W   W
WWW WWWXWW