WWWWWWWWWW
W T b  A W
WA       W
WBW      W
W       CW
WY   CC XW
W    WWW W
W        W
W AA   FSW
WWWWWWWXWW