WWWWWWWWWW
W C B    W
W  HHHH  W
W    S   W
W    WWXXW
W    W
W    W   W
W  F  W  W
W  R     W
WWWWWWWWWW