WWWWWWWWWW
WBA X  S W
W   W C  W
WWWYWWWXWW
W   V    W
W H V    W
W        W
W WWWWWW W
W  T     W
WWWW WWWWW