WWWWWWWWWW     
W   B    W
W  HHHH  W
W    S  CW
W    WWXXW
W    W
W   F  W W
W     W  W
W  R     W
WWWWWWWWWW