WWWWWWWWWW
WA BbW S W
W    W   W
W    WXXXW
W        W
W    WXWXW
W    W   W
W    WWWXW
W T  W   W
WWW WWWXWW